+-+-+-+-+--+-+-+-+-+-+
|/|/| |  |%|S| | | | |
+-+-+-+-+--+-+-+-+-+-+
|D| | |C1| | | | | | |
+-+-+-+-+--+-+-+-+-+-+